11 30	
|----------------------------|
|.Z...|..Z..|Z...|..|..|.....|
|..|..|...Z.|...|..|...|....Z|
|..|..|....Z..|...|..|...Z..Z|
|.....|..Z.Z.|.Z..|...|...|..|
|..|..|...Z..|...|.Z.|..Z.|..|  
|..|..|...Z....|...|.|..|....|
|@..|P.|..Z..|..Z....|.Z....Z|
|..|..|.|...Z..|..Z.|...|.|..|
|..|.......|..Z...|...|.....Z|
|----------------------------|